111111111111
100000000001
101110111101
100010000101
111010110101
100000100001
111111111111