111111111111111
100000000010001
111010111010101
100000000000101
101111101111101
100010001000001
111010111011101
100000000010001
101110111110111
100010001000001
111011101011101
100000100010001
101110111010111
100000000000001
111111111111111